NO textures/edited/wallN.xpm
SO textures/edited/wallS.xpm
WE textures/edited/wallW.xpm
EA textures/edited/wallE.xpm

F 155,118,83
C 135,206,235

        1111111111111111111111111
        100000000011000E000001001
        1011000001110000000001001
        1001000000000000010000001
111111111011000001110000010000001
100000000011000001110111111111101
11110111111111011100000000001 101
11110111111111011101010010001 101
11000000110101011100000010001 101
10000000000000001100000010001 111
100000000000000011010100100011	1
1100000111010101111101111000101
11110111 1110101 10111101000111
11111111 1111111 111111111111
